-zork
-q
-i
-l
-z
-again
-verbos
-brief
-super
-diagno
-restar
-restor
-save
-score
-script
-unscri
-versio
-back
-plugh
-curse
-win
-odysse
-froboz
-say
-echo
-barf
-blast
-peal
brandi=brandish
treasu=treasure
squeez=squeeze
punctu=puncture
liquif=liquify
dispat=dispatch
inflat=inflate
descri=describe
enchan=enchant
disenc=disenchant
disemb=disembowl
deflat=deflate
comman=command
activa=activate
procee=proceed
startl=startle
surpri=surprise
unatta=unattach
unfast=unfasten
odysse=odyssey
ulysse=ulysses
lubric=lubricate
exting=extinguish
exorci=exorcise
examin=examine
consum=consume
releas=release
swallo=swallow
destro=destroy
incine=incinerate
northw=northwest
northe=northeast
southw=southwest
southe=southeast
engrav=engraving
guideb=guidebook
stairw=stairwell
sceptr=sceptre
materi=material
rainbo=rainbow
crawlw=crawlway
pedest=pedestal
footpa=footpath
machin=machine
gratin=grating
diamon=diamond
advent=adventure
stilet=stiletto
vampir=vampire
mounta=mountain
contai=container
platin=plating
skelet=skeleton
sandwi=sandwich
plasti=plastic
finepr=fineprint
reflec=reflection
songbi=songbird
blessi=blessing
painti=painting
passag=passage
bracel=bracelet
enormo=enormous
cyclop=cyclops
matche=matches
matchb=matchbook
overbo=overboard
lanter=lantern
toolch=toolchain
aviato=aviator
zorkmi=zorkmid
writin=writing
screwd=screwdriver
chimne=chimney
quanti=quantity
triden=trident
parchm=parchment
monste=monster
figuri=figurine
mailbo=mailbox
inscri=inscription
trapdo=trapdoor
glamdr=glamdring
emeral=emerald
bookle=booklet
railin=railing
leafle=leaflet
stairc=staircase
sapphi=sapphire
hemloc=hemlock
